9 11
+-+-+-+-+-+
|         |
+ + + +-+-+
| | |     |
+ +-+ +-+-+
| |       |
+ +-+-+-+ +
|       | |
+-+-+-+-+-+